NO ./textures/NO.xpm
SO ./textures/SO.xpm
WE ./textures/WE.xpm


EA ./textures/EA.xpm
EX ./textures/exit.xpm

F 210,100,0
C 225,30,0

        1111111111111111111111111
        1000000000110000000000001
        1011000001110000000000001
        1001000000000000000000001
101111111011000001110000000000001
100000000011000001110111110111111
111101111111110111000000100011
11110111111111011101010010001
11000000110101011100000010001
1000S000000000001100000010001
10000000Q00000001101010010001
11000001110101011111011110001111
11110111 1110101 101111010001
11111111 1111111 111111111111
